

§ {NUCLEUS}
æ → a (???)
y → i
ø/œ → ɤ
ɨ → ɤ
ʉ → u
ɐ → a
ɯ → ɤ


§ ._V:
# Between a syllable break and a vowel:
θ → t (?)
ð → d (?)
q → k
c/tj/tʲ → t͡ɕ
ɟ/dj/dʲ → d͡ʑ
z → d͡z
v → b
ç → ɕ
ʝ → d͡ʑ
x → h
ɣ → ɡ
ʁ → h (?)
j → d͡ʑ
w → b
ɹ/ɻ → r (?)
ʕ → h
nj/nʲ → ɲ
ŋ → n
ʎ/lj/lʲ/ → l
ɺ|ʀ → r


§ _. | _C:
# Before a consonant or a syllable break:
CwV, CʷV → CuV
CrV → ???
ClV → CiV
CɫV → CuV
CVr → ???
CVl → CVi
CVɫ → CVu
CVC → ???

